ក	k
ខ	kh
គ	g
ឃ	gh
ង	ng
ច	ch
ឆ	chh
ជ	jh
ឈ	jhh
ញ	n~
ដ	T
ឋ	Th
ឌ	D
ឍ	Dh
ណ	N
ត	t
ថ	th
ទ	d
ធ	dh
ន	n
ប	p
ផ	ph
ព	b
ភ	bh
ម	m
យ	y
រ	r
ល	l
វ	v
ឝ	sh
ឞ	S
ស	s
ហ	h
ឡ	L
អ	q
